統計表１　生活保護の被保護世帯数及び実人員,...2,...3,...4,...5,...6,...7,...8,...9,...10,...11,year_month
全国,NA,NA,1641087,1632629,8458,2127205,2115400,11805,17448,15801,2017-07-01
NA,北海道,NA,49488,49407,81,65582,65478,104,412,479,2017-07-01
NA,青森,NA,13633,13614,19,16765,16741,24,100,98,2017-07-01
NA,岩手,NA,6699,6655,44,8559,8501,58,82,60,2017-07-01
NA,宮城,NA,7951,7913,38,10596,10549,47,115,75,2017-07-01
NA,秋田,NA,7284,7260,24,9386,9349,37,67,59,2017-07-01
NA,山形,NA,6200,6136,64,7648,7553,95,53,49,2017-07-01
NA,福島,NA,7691,7623,68,9505,9436,69,85,76,2017-07-01
NA,茨城,NA,21531,21419,112,27429,27279,150,268,193,2017-07-01
NA,栃木,NA,10029,9983,46,12596,12518,78,116,107,2017-07-01
NA,群馬,NA,6284,6253,31,7755,7711,44,49,55,2017-07-01
NA,埼玉,NA,51993,51829,164,68916,68686,230,565,434,2017-07-01
NA,千葉,NA,39165,38976,189,50865,50592,273,517,378,2017-07-01
NA,東京,NA,225399,224330,1069,282033,280498,1535,2471,2157,2017-07-01
NA,神奈川,NA,26478,26361,117,34861,34695,166,331,273,2017-07-01
NA,新潟,NA,7083,7029,54,8994,8919,75,86,90,2017-07-01
NA,富山,NA,1477,1458,19,1710,1684,26,17,16,2017-07-01
NA,石川,NA,2695,2661,34,3127,3089,38,21,32,2017-07-01
NA,福井,NA,3404,3351,53,4195,4118,77,48,36,2017-07-01
NA,山梨,NA,5659,5576,83,7030,6930,100,70,46,2017-07-01
NA,長野,NA,6449,6393,56,7959,7882,77,64,84,2017-07-01
NA,岐阜,NA,4392,4331,61,5419,5352,67,47,48,2017-07-01
NA,静岡,NA,11888,11805,83,14780,14662,118,178,113,2017-07-01
NA,愛知,NA,17840,17719,121,23295,23091,204,213,191,2017-07-01
NA,三重,NA,12769,12675,94,16401,16281,120,112,153,2017-07-01
NA,滋賀,NA,5177,5134,43,7257,7193,64,61,59,2017-07-01
NA,京都,NA,10343,10266,77,14791,14677,114,113,113,2017-07-01
NA,大阪,NA,56572,56355,217,77448,77122,326,535,546,2017-07-01
NA,兵庫,NA,17720,17595,125,23835,23648,187,189,161,2017-07-01
NA,奈良,NA,9592,9527,65,12957,12853,104,92,65,2017-07-01
NA,和歌山,NA,4973,4942,31,6111,6076,35,46,33,2017-07-01
NA,鳥取,NA,5569,5521,48,7336,7266,70,53,56,2017-07-01
NA,島根,NA,4656,4641,15,5945,5927,18,48,58,2017-07-01
NA,岡山,NA,3958,3940,18,5047,5027,20,41,46,2017-07-01
NA,広島,NA,5946,5887,59,8017,7929,88,71,68,2017-07-01
NA,山口,NA,8979,8931,48,11276,11215,61,87,78,2017-07-01
NA,徳島,NA,10744,10704,40,13835,13782,53,62,88,2017-07-01
NA,香川,NA,3463,3433,30,4477,4439,38,38,46,2017-07-01
NA,愛媛,NA,7647,7581,66,9439,9354,85,62,65,2017-07-01
NA,高知,NA,5889,5828,61,7417,7342,75,50,51,2017-07-01
NA,福岡,NA,38811,38654,157,53960,53702,258,308,298,2017-07-01
NA,佐賀,NA,6462,6407,55,7909,7834,75,62,59,2017-07-01
NA,長崎,NA,8054,8016,38,10648,10595,53,66,78,2017-07-01
NA,熊本,NA,7497,7450,47,9532,9471,61,88,80,2017-07-01
NA,大分,NA,9202,9102,100,11452,11321,131,69,86,2017-07-01
NA,宮崎,NA,7458,7422,36,9321,9273,48,81,92,2017-07-01
NA,鹿児島,NA,12257,12154,103,15948,15779,169,103,122,2017-07-01
NA,沖縄,NA,18535,18435,100,24259,24115,144,220,170,2017-07-01
指定都市（別掲）,NA,NA,NA,NA,NA,NA,NA,NA,NA,NA,2017-07-01
NA,札幌市,NA,54589,54406,183,73099,72878,221,605,505,2017-07-01
NA,仙台市,NA,13374,13308,66,17925,17824,101,158,130,2017-07-01
NA,さいたま市,NA,15411,15333,78,20233,20107,126,181,168,2017-07-01
NA,千葉市,NA,16511,16313,198,20789,20508,281,277,225,2017-07-01
NA,横浜市,NA,53762,53643,119,70395,70209,186,716,641,2017-07-01
NA,川崎市,NA,24363,24310,53,31731,31653,78,348,306,2017-07-01
NA,相模原市,NA,10093,10066,27,14059,14015,44,117,86,2017-07-01
NA,新潟市,NA,9058,9000,58,11941,11855,86,85,84,2017-07-01
NA,静岡市,NA,7074,7022,52,9073,9003,70,73,57,2017-07-01
NA,浜松市,NA,5754,5681,73,7427,7325,102,87,94,2017-07-01
NA,名古屋市,NA,38677,38455,222,48855,48546,309,590,537,2017-07-01
NA,京都市,NA,32903,32517,386,44712,44157,555,327,341,2017-07-01
NA,大阪市,NA,115688,114901,787,142658,141616,1042,1345,1251,2017-07-01
NA,堺市,NA,19247,19199,48,25780,25715,65,214,181,2017-07-01
NA,神戸市,NA,34818,34652,166,46987,46765,222,323,319,2017-07-01
NA,岡山市,NA,10024,9992,32,13456,13417,39,124,105,2017-07-01
NA,広島市,NA,19091,19010,81,25674,25553,121,200,225,2017-07-01
NA,北九州市,NA,18584,18525,59,23556,23484,72,162,146,2017-07-01
NA,福岡市,NA,33610,33484,126,43710,43549,161,371,322,2017-07-01
NA,熊本市,NA,12136,12075,61,15939,15862,77,142,142,2017-07-01
中核市　（別掲）,NA,NA,NA,NA,NA,NA,NA,NA,NA,NA,2017-07-01
NA,旭川市,NA,10035,9998,37,12968,12915,53,71,83,2017-07-01
NA,函館市,NA,9453,9437,16,12123,12104,19,102,96,2017-07-01
NA,青森市,NA,6797,6793,4,8643,8635,8,47,40,2017-07-01
NA,八戸市,NA,3639,3622,17,4584,4561,23,23,31,2017-07-01
NA,盛岡市,NA,3769,3756,13,4800,4779,21,44,32,2017-07-01
NA,秋田市,NA,4294,4286,8,5393,5382,11,39,31,2017-07-01
NA,郡山市,NA,2633,2625,8,3288,3280,8,28,21,2017-07-01
NA,いわき市,NA,3255,3232,23,4244,4218,26,33,35,2017-07-01
NA,宇都宮市,NA,6672,6615,57,8614,8536,78,64,51,2017-07-01
NA,前橋市,NA,3166,3114,52,3903,3833,70,24,24,2017-07-01
NA,高崎市,NA,2859,2842,17,3470,3445,25,32,30,2017-07-01
NA,川越市,NA,3334,3330,4,4439,4435,4,35,21,2017-07-01
NA,越谷市,NA,3012,2993,19,4090,4060,30,40,19,2017-07-01
NA,船橋市,NA,6938,6895,43,8985,8924,61,63,51,2017-07-01
NA,柏市,NA,3465,3462,3,4561,4558,3,49,32,2017-07-01
NA,八王子市,NA,7599,7582,17,9931,9910,21,46,60,2017-07-01
NA,横須賀市,NA,4058,4027,31,5330,5287,43,36,29,2017-07-01
NA,富山市,NA,1633,1631,2,1866,1864,2,23,21,2017-07-01
NA,金沢市,NA,3710,3686,24,4380,4354,26,35,30,2017-07-01
NA,長野市,NA,2554,2537,17,3274,3249,25,32,21,2017-07-01
NA,岐阜市,NA,5308,5260,48,6546,6488,58,36,42,2017-07-01
NA,豊橋市,NA,1804,1798,6,2220,2208,12,19,21,2017-07-01
NA,豊田市,NA,1761,1755,6,2428,2419,9,29,18,2017-07-01
NA,岡崎市,NA,1566,1555,11,2036,2022,14,36,27,2017-07-01
NA,大津市,NA,3100,3080,20,4140,4116,24,31,26,2017-07-01
NA,高槻市,NA,4224,4216,8,6062,6050,12,30,32,2017-07-01
NA,東大阪市,NA,14617,14546,71,19675,19573,102,119,122,2017-07-01
NA,豊中市,NA,7702,7664,38,10315,10245,70,63,53,2017-07-01
NA,枚方市,NA,5742,5715,27,7949,7904,45,64,43,2017-07-01
NA,姫路市,NA,6845,6832,13,8874,8858,16,70,63,2017-07-01
NA,西宮市,NA,5949,5894,55,8152,8068,84,42,28,2017-07-01
NA,尼崎市,NA,13910,13881,29,18250,18214,36,117,96,2017-07-01
NA,奈良市,NA,5476,5389,87,7612,7467,145,42,31,2017-07-01
NA,和歌山市,NA,7718,7710,8,9290,9280,10,74,66,2017-07-01
NA,倉敷市,NA,5260,5248,12,7298,7280,18,57,54,2017-07-01
NA,福山市,NA,4905,4890,15,6519,6503,16,41,36,2017-07-01
NA,呉市,NA,2968,2946,22,3776,3748,28,23,34,2017-07-01
NA,下関市,NA,3454,3436,18,4362,4338,24,27,32,2017-07-01
NA,高松市,NA,4792,4757,35,6117,6075,42,32,38,2017-07-01
NA,松山市,NA,9926,9917,9,12328,12312,16,70,50,2017-07-01
NA,高知市,NA,9293,9229,64,12173,12076,97,64,90,2017-07-01
NA,久留米市,NA,5190,5185,5,6767,6761,6,49,19,2017-07-01
NA,長崎市,NA,9593,9553,40,12938,12876,62,53,45,2017-07-01
NA,佐世保市,NA,4211,4193,18,5535,5507,28,37,39,2017-07-01
NA,大分市,NA,6935,6899,36,8673,8630,43,52,56,2017-07-01
NA,宮崎市,NA,6905,6882,23,8833,8808,25,59,42,2017-07-01
NA,鹿児島市,NA,11730,11599,131,15312,15171,141,95,74,2017-07-01
NA,那覇市,NA,9576,9563,13,12517,12499,18,74,81,2017-07-01
