統計表１　生活保護の被保護世帯数及び実人員,...2,...3,...4,...5,...6,...7,...8,...9,...10,...11,year_month
全国,NA,NA,1642614,1634171,8443,2123290,2111685,11605,16615,17126,2017-12-01
NA,北海道,NA,49283,49220,63,65107,65030,77,469,426,2017-12-01
NA,青森,NA,13687,13671,16,16801,16780,21,99,83,2017-12-01
NA,岩手,NA,6701,6667,34,8541,8496,45,88,75,2017-12-01
NA,宮城,NA,8061,8008,53,10753,10678,75,110,85,2017-12-01
NA,秋田,NA,7186,7167,19,9262,9239,23,56,105,2017-12-01
NA,山形,NA,6308,6256,52,7770,7705,65,78,62,2017-12-01
NA,福島,NA,7778,7719,59,9611,9550,61,108,81,2017-12-01
NA,茨城,NA,21844,21730,114,27739,27584,155,274,245,2017-12-01
NA,栃木,NA,9979,9918,61,12473,12382,91,112,99,2017-12-01
NA,群馬,NA,6275,6236,39,7679,7627,52,63,86,2017-12-01
NA,埼玉,NA,52289,52095,194,69027,68753,274,528,543,2017-12-01
NA,千葉,NA,39547,39352,195,51221,50957,264,467,409,2017-12-01
NA,東京,NA,225670,224608,1062,281805,280265,1540,2079,2234,2017-12-01
NA,神奈川,NA,26617,26492,125,34890,34723,167,316,300,2017-12-01
NA,新潟,NA,7097,7039,58,8997,8910,87,96,79,2017-12-01
NA,富山,NA,1462,1431,31,1705,1664,41,15,15,2017-12-01
NA,石川,NA,2674,2649,25,3107,3080,27,18,29,2017-12-01
NA,福井,NA,3398,3336,62,4172,4101,71,36,44,2017-12-01
NA,山梨,NA,5721,5651,70,7122,7028,94,69,53,2017-12-01
NA,長野,NA,6395,6321,74,7856,7752,104,78,97,2017-12-01
NA,岐阜,NA,4381,4317,64,5401,5326,75,33,69,2017-12-01
NA,静岡,NA,11954,11866,88,14778,14665,113,135,137,2017-12-01
NA,愛知,NA,17826,17692,134,23208,23010,198,199,219,2017-12-01
NA,三重,NA,12717,12624,93,16259,16124,135,128,161,2017-12-01
NA,滋賀,NA,5187,5137,50,7278,7200,78,64,70,2017-12-01
NA,京都,NA,10293,10203,90,14694,14550,144,77,99,2017-12-01
NA,大阪,NA,56711,56514,197,77368,77074,294,566,561,2017-12-01
NA,兵庫,NA,17834,17713,121,23935,23753,182,204,224,2017-12-01
NA,奈良,NA,9588,9528,60,12941,12849,92,98,85,2017-12-01
NA,和歌山,NA,4966,4932,34,6082,6041,41,49,51,2017-12-01
NA,鳥取,NA,5568,5531,37,7303,7248,55,76,72,2017-12-01
NA,島根,NA,4627,4609,18,5905,5882,23,53,61,2017-12-01
NA,岡山,NA,3894,3869,25,4956,4917,39,52,67,2017-12-01
NA,広島,NA,5942,5899,43,7962,7892,70,69,68,2017-12-01
NA,山口,NA,8880,8829,51,11109,11043,66,82,92,2017-12-01
NA,徳島,NA,10713,10674,39,13762,13700,62,98,92,2017-12-01
NA,香川,NA,3455,3434,21,4444,4416,28,41,38,2017-12-01
NA,愛媛,NA,7671,7604,67,9474,9383,91,80,84,2017-12-01
NA,高知,NA,5884,5835,49,7385,7322,63,72,68,2017-12-01
NA,福岡,NA,38614,38458,156,53506,53263,243,307,312,2017-12-01
NA,佐賀,NA,6472,6433,39,7875,7821,54,60,66,2017-12-01
NA,長崎,NA,8050,8020,30,10591,10556,35,81,67,2017-12-01
NA,熊本,NA,7516,7479,37,9531,9479,52,104,113,2017-12-01
NA,大分,NA,9157,9061,96,11357,11239,118,70,97,2017-12-01
NA,宮崎,NA,7411,7375,36,9240,9195,45,80,92,2017-12-01
NA,鹿児島,NA,12134,11991,143,15778,15559,219,118,139,2017-12-01
NA,沖縄,NA,18746,18641,105,24435,24285,150,224,185,2017-12-01
指定都市（別掲）,NA,NA,NA,NA,NA,NA,NA,NA,NA,NA,2017-12-01
NA,札幌市,NA,54920,54808,112,73310,73171,139,625,589,2017-12-01
NA,仙台市,NA,13509,13438,71,18037,17939,98,138,147,2017-12-01
NA,さいたま市,NA,15386,15293,93,20126,19987,139,189,192,2017-12-01
NA,千葉市,NA,16607,16384,223,20876,20563,313,242,219,2017-12-01
NA,横浜市,NA,53977,53881,96,70536,70396,140,660,658,2017-12-01
NA,川崎市,NA,24279,24219,60,31531,31453,78,285,263,2017-12-01
NA,相模原市,NA,10130,10095,35,14016,13950,66,102,105,2017-12-01
NA,新潟市,NA,9104,9057,47,11983,11923,60,91,79,2017-12-01
NA,静岡市,NA,7144,7084,60,9161,9093,68,88,60,2017-12-01
NA,浜松市,NA,5710,5630,80,7316,7197,119,83,72,2017-12-01
NA,名古屋市,NA,38518,38299,219,48543,48259,284,483,520,2017-12-01
NA,京都市,NA,32799,32437,362,44473,43979,494,218,339,2017-12-01
NA,大阪市,NA,115360,114629,731,141855,140950,905,1267,1423,2017-12-01
NA,堺市,NA,19280,19228,52,25820,25746,74,179,180,2017-12-01
NA,神戸市,NA,34724,34563,161,46751,46539,212,314,345,2017-12-01
NA,岡山市,NA,10036,9999,37,13453,13410,43,119,109,2017-12-01
NA,広島市,NA,19090,19007,83,25528,25419,109,236,217,2017-12-01
NA,北九州市,NA,18583,18493,90,23546,23447,99,165,189,2017-12-01
NA,福岡市,NA,33720,33592,128,43817,43654,163,362,346,2017-12-01
NA,熊本市,NA,12112,12059,53,15832,15759,73,150,144,2017-12-01
中核市　（別掲）,NA,NA,NA,NA,NA,NA,NA,NA,NA,NA,2017-12-01
NA,旭川市,NA,10026,10001,25,12881,12844,37,91,72,2017-12-01
NA,函館市,NA,9440,9430,10,12052,12042,10,92,68,2017-12-01
NA,青森市,NA,6816,6808,8,8622,8613,9,37,45,2017-12-01
NA,八戸市,NA,3655,3642,13,4578,4564,14,23,20,2017-12-01
NA,盛岡市,NA,3787,3773,14,4804,4780,24,33,37,2017-12-01
NA,秋田市,NA,4277,4272,5,5370,5362,8,29,30,2017-12-01
NA,郡山市,NA,2647,2635,12,3285,3273,12,30,30,2017-12-01
NA,いわき市,NA,3283,3260,23,4287,4260,27,43,40,2017-12-01
NA,宇都宮市,NA,6719,6656,63,8672,8585,87,44,66,2017-12-01
NA,前橋市,NA,3182,3136,46,3893,3833,60,35,23,2017-12-01
NA,高崎市,NA,2887,2866,21,3496,3470,26,37,28,2017-12-01
NA,川越市,NA,3361,3356,5,4440,4433,7,31,29,2017-12-01
NA,越谷市,NA,3048,3029,19,4118,4083,35,36,22,2017-12-01
NA,船橋市,NA,6959,6923,36,8990,8938,52,70,64,2017-12-01
NA,柏市,NA,3508,3503,5,4611,4606,5,50,42,2017-12-01
NA,八王子市,NA,7528,7517,11,9730,9712,18,48,70,2017-12-01
NA,横須賀市,NA,4076,4046,30,5327,5285,42,35,43,2017-12-01
NA,富山市,NA,1648,1643,5,1875,1869,6,19,25,2017-12-01
NA,金沢市,NA,3676,3647,29,4320,4287,33,36,42,2017-12-01
NA,長野市,NA,2551,2537,14,3237,3218,19,27,26,2017-12-01
NA,岐阜市,NA,5320,5263,57,6540,6447,93,35,47,2017-12-01
NA,豊橋市,NA,1777,1766,11,2159,2142,17,9,18,2017-12-01
NA,豊田市,NA,1759,1748,11,2398,2381,17,21,41,2017-12-01
NA,岡崎市,NA,1553,1544,9,2022,2006,16,15,20,2017-12-01
NA,大津市,NA,3097,3067,30,4113,4074,39,27,44,2017-12-01
NA,高槻市,NA,4267,4258,9,6109,6098,11,33,37,2017-12-01
NA,東大阪市,NA,14602,14538,64,19586,19495,91,120,148,2017-12-01
NA,豊中市,NA,7684,7651,33,10263,10210,53,47,81,2017-12-01
NA,枚方市,NA,5733,5711,22,7888,7852,36,42,39,2017-12-01
NA,姫路市,NA,6798,6777,21,8767,8742,25,58,67,2017-12-01
NA,西宮市,NA,5967,5898,69,8143,8027,116,50,49,2017-12-01
NA,尼崎市,NA,13915,13877,38,18310,18260,50,68,104,2017-12-01
NA,奈良市,NA,5492,5404,88,7569,7437,132,50,36,2017-12-01
NA,和歌山市,NA,7747,7736,11,9316,9303,13,62,60,2017-12-01
NA,倉敷市,NA,5279,5272,7,7322,7314,8,58,62,2017-12-01
NA,福山市,NA,4877,4870,7,6485,6476,9,29,41,2017-12-01
NA,呉市,NA,2915,2895,20,3712,3686,26,19,24,2017-12-01
NA,下関市,NA,3426,3411,15,4323,4303,20,30,28,2017-12-01
NA,高松市,NA,4817,4765,52,6140,6080,60,42,39,2017-12-01
NA,松山市,NA,9921,9907,14,12274,12252,22,68,62,2017-12-01
NA,高知市,NA,9254,9196,58,12076,11990,86,55,71,2017-12-01
NA,久留米市,NA,5220,5210,10,6800,6787,13,27,42,2017-12-01
NA,長崎市,NA,9608,9552,56,12899,12817,82,77,72,2017-12-01
NA,佐世保市,NA,4159,4143,16,5427,5404,23,38,33,2017-12-01
NA,大分市,NA,6903,6871,32,8609,8567,42,53,63,2017-12-01
NA,宮崎市,NA,6919,6885,34,8838,8801,37,68,68,2017-12-01
NA,鹿児島市,NA,11731,11609,122,15304,15155,149,89,100,2017-12-01
NA,那覇市,NA,9649,9638,11,12605,12592,13,104,73,2017-12-01
