統計表１　生活保護の被保護世帯数及び実人員,...2,...3,...4,...5,...6,...7,...8,...9,...10,...11,year_month
全国,NA,NA,1638944,1630857,8087,2141881,2130842,11039,16943,17168,2017-02-01
NA,北海道,NA,49852,49792,60,66728,66657,71,398,409,2017-02-01
NA,青森,NA,13592,13582,10,16829,16818,11,112,93,2017-02-01
NA,岩手,NA,6715,6673,42,8676,8614,62,66,68,2017-02-01
NA,宮城,NA,7829,7794,35,10477,10426,51,108,94,2017-02-01
NA,秋田,NA,7326,7306,20,9523,9501,22,51,58,2017-02-01
NA,山形,NA,6180,6140,40,7672,7613,59,75,58,2017-02-01
NA,福島,NA,7610,7536,74,9437,9360,77,87,84,2017-02-01
NA,茨城,NA,21246,21126,120,27165,27013,152,258,225,2017-02-01
NA,栃木,NA,10055,9999,56,12787,12708,79,115,101,2017-02-01
NA,群馬,NA,6249,6206,43,7754,7699,55,69,65,2017-02-01
NA,埼玉,NA,51596,51411,185,69068,68807,261,591,514,2017-02-01
NA,千葉,NA,38728,38567,161,50664,50435,229,498,408,2017-02-01
NA,東京,NA,224798,223731,1067,282858,281414,1444,2200,2350,2017-02-01
NA,神奈川,NA,26255,26155,100,34911,34767,144,321,274,2017-02-01
NA,新潟,NA,7118,7071,47,9136,9068,68,83,89,2017-02-01
NA,富山,NA,1501,1483,18,1749,1723,26,17,22,2017-02-01
NA,石川,NA,2709,2686,23,3153,3124,29,29,31,2017-02-01
NA,福井,NA,3354,3306,48,4176,4117,59,45,47,2017-02-01
NA,山梨,NA,5615,5550,65,7031,6946,85,67,60,2017-02-01
NA,長野,NA,6530,6468,62,8181,8100,81,87,79,2017-02-01
NA,岐阜,NA,4380,4317,63,5458,5380,78,40,52,2017-02-01
NA,静岡,NA,11737,11658,79,14676,14572,104,163,141,2017-02-01
NA,愛知,NA,17742,17643,99,23415,23266,149,208,215,2017-02-01
NA,三重,NA,12832,12739,93,16606,16477,129,121,160,2017-02-01
NA,滋賀,NA,5212,5177,35,7430,7379,51,57,53,2017-02-01
NA,京都,NA,10340,10263,77,15020,14901,119,112,92,2017-02-01
NA,大阪,NA,56624,56409,215,78479,78103,376,481,578,2017-02-01
NA,兵庫,NA,17610,17487,123,23881,23705,176,182,165,2017-02-01
NA,奈良,NA,9592,9522,70,13057,12955,102,82,94,2017-02-01
NA,和歌山,NA,4970,4935,35,6140,6091,49,40,55,2017-02-01
NA,鳥取,NA,5626,5591,35,7476,7437,39,49,58,2017-02-01
NA,島根,NA,4653,4641,12,5972,5959,13,48,55,2017-02-01
NA,岡山,NA,3992,3972,20,5133,5104,29,50,40,2017-02-01
NA,広島,NA,5957,5908,49,8118,8050,68,71,67,2017-02-01
NA,山口,NA,8994,8954,40,11376,11320,56,76,96,2017-02-01
NA,徳島,NA,10798,10774,24,14007,13974,33,72,102,2017-02-01
NA,香川,NA,3452,3421,31,4471,4429,42,33,44,2017-02-01
NA,愛媛,NA,7668,7615,53,9508,9447,61,98,84,2017-02-01
NA,高知,NA,5925,5882,43,7536,7474,62,55,79,2017-02-01
NA,福岡,NA,39027,38889,138,54781,54563,218,264,341,2017-02-01
NA,佐賀,NA,6468,6397,71,7962,7875,87,80,66,2017-02-01
NA,長崎,NA,8100,8056,44,10827,10777,50,58,85,2017-02-01
NA,熊本,NA,7483,7442,41,9583,9533,50,82,94,2017-02-01
NA,大分,NA,9235,9132,103,11549,11420,129,80,80,2017-02-01
NA,宮崎,NA,7494,7460,34,9462,9414,48,87,90,2017-02-01
NA,鹿児島,NA,12359,12243,116,16216,16048,168,134,146,2017-02-01
NA,沖縄,NA,18349,18265,84,24282,24154,128,181,165,2017-02-01
指定都市（別掲）,NA,NA,NA,NA,NA,NA,NA,NA,NA,NA,2017-02-01
NA,札幌市,NA,54518,54382,136,73758,73594,164,589,536,2017-02-01
NA,仙台市,NA,13253,13204,49,17886,17817,69,183,164,2017-02-01
NA,さいたま市,NA,15399,15311,88,20293,20176,117,168,179,2017-02-01
NA,千葉市,NA,16330,16131,199,20703,20396,307,261,230,2017-02-01
NA,横浜市,NA,53765,53663,102,70919,70756,163,704,619,2017-02-01
NA,川崎市,NA,24310,24271,39,31902,31841,61,315,340,2017-02-01
NA,相模原市,NA,10024,9986,38,14054,14000,54,114,92,2017-02-01
NA,新潟市,NA,8997,8942,55,11926,11862,64,100,69,2017-02-01
NA,静岡市,NA,7045,6996,49,9087,9025,62,83,68,2017-02-01
NA,浜松市,NA,5735,5654,81,7420,7307,113,94,82,2017-02-01
NA,名古屋市,NA,38579,38350,229,49101,48804,297,563,618,2017-02-01
NA,京都市,NA,33006,32591,415,45238,44663,575,331,380,2017-02-01
NA,大阪市,NA,115740,114968,772,143802,142748,1054,1207,1352,2017-02-01
NA,堺市,NA,19170,19126,44,25904,25846,58,211,195,2017-02-01
NA,神戸市,NA,34905,34737,168,47572,47350,222,358,326,2017-02-01
NA,岡山市,NA,9998,9955,43,13577,13526,51,106,127,2017-02-01
NA,広島市,NA,19288,19211,77,26206,26108,98,207,277,2017-02-01
NA,北九州市,NA,18562,18493,69,23728,23647,81,167,171,2017-02-01
NA,福岡市,NA,33549,33472,77,44066,43974,92,415,355,2017-02-01
NA,熊本市,NA,12257,12208,49,16246,16183,63,155,214,2017-02-01
中核市　（別掲）,NA,NA,NA,NA,NA,NA,NA,NA,NA,NA,2017-02-01
NA,旭川市,NA,10090,10067,23,13210,13183,27,69,76,2017-02-01
NA,函館市,NA,9481,9464,17,12235,12215,20,71,84,2017-02-01
NA,青森市,NA,6792,6792,0,8668,8668,0,44,42,2017-02-01
NA,八戸市,NA,3636,3620,16,4605,4585,20,22,17,2017-02-01
NA,盛岡市,NA,3731,3720,11,4789,4775,14,44,31,2017-02-01
NA,秋田市,NA,4267,4261,6,5402,5394,8,32,25,2017-02-01
NA,郡山市,NA,2626,2616,10,3286,3276,10,24,35,2017-02-01
NA,いわき市,NA,3238,3214,24,4233,4209,24,45,50,2017-02-01
NA,宇都宮市,NA,6697,6633,64,8729,8652,77,59,71,2017-02-01
NA,前橋市,NA,3178,3134,44,3952,3895,57,33,34,2017-02-01
NA,高崎市,NA,2826,2819,7,3446,3439,7,36,32,2017-02-01
NA,川越市,NA,3325,3319,6,4475,4467,8,35,28,2017-02-01
NA,越谷市,NA,2989,2971,18,4080,4053,27,38,28,2017-02-01
NA,船橋市,NA,6854,6822,32,8965,8919,46,76,78,2017-02-01
NA,柏市,NA,3427,3421,6,4559,4546,13,48,44,2017-02-01
NA,八王子市,NA,7656,7638,18,10116,10095,21,47,75,2017-02-01
NA,横須賀市,NA,4019,3991,28,5301,5257,44,24,44,2017-02-01
NA,富山市,NA,1582,1581,1,1810,1809,1,24,17,2017-02-01
NA,金沢市,NA,3705,3690,15,4408,4393,15,35,27,2017-02-01
NA,長野市,NA,2524,2508,16,3225,3203,22,27,28,2017-02-01
NA,岐阜市,NA,5317,5279,38,6595,6541,54,48,49,2017-02-01
NA,豊橋市,NA,1808,1800,8,2253,2242,11,18,18,2017-02-01
NA,豊田市,NA,1754,1743,11,2434,2420,14,23,18,2017-02-01
NA,岡崎市,NA,1533,1519,14,2005,1990,15,25,14,2017-02-01
NA,大津市,NA,3101,3085,16,4196,4178,18,35,26,2017-02-01
NA,高槻市,NA,4256,4248,8,6143,6133,10,33,35,2017-02-01
NA,東大阪市,NA,14662,14609,53,19839,19764,75,111,99,2017-02-01
NA,豊中市,NA,7646,7611,35,10363,10308,55,65,64,2017-02-01
NA,枚方市,NA,5693,5677,16,7993,7973,20,65,51,2017-02-01
NA,姫路市,NA,6813,6801,12,8903,8880,23,70,54,2017-02-01
NA,西宮市,NA,5973,5920,53,8207,8122,85,53,46,2017-02-01
NA,尼崎市,NA,13857,13830,27,18296,18256,40,105,92,2017-02-01
NA,奈良市,NA,5486,5404,82,7709,7578,131,39,47,2017-02-01
NA,和歌山市,NA,7724,7709,15,9334,9316,18,82,82,2017-02-01
NA,倉敷市,NA,5239,5227,12,7328,7313,15,69,50,2017-02-01
NA,福山市,NA,4903,4892,11,6579,6566,13,29,59,2017-02-01
NA,呉市,NA,3002,2972,30,3869,3827,42,24,33,2017-02-01
NA,下関市,NA,3488,3468,20,4467,4446,21,29,29,2017-02-01
NA,高松市,NA,4840,4788,52,6253,6183,70,48,61,2017-02-01
NA,松山市,NA,9954,9941,13,12430,12413,17,59,60,2017-02-01
NA,高知市,NA,9339,9289,50,12352,12280,72,59,65,2017-02-01
NA,久留米市,NA,5151,5143,8,6760,6751,9,45,42,2017-02-01
NA,長崎市,NA,9637,9599,38,13137,13079,58,64,71,2017-02-01
NA,佐世保市,NA,4200,4184,16,5578,5555,23,33,32,2017-02-01
NA,大分市,NA,6918,6885,33,8733,8690,43,52,62,2017-02-01
NA,宮崎市,NA,6907,6869,38,8882,8841,41,62,73,2017-02-01
NA,鹿児島市,NA,11727,11598,129,15463,15327,136,78,80,2017-02-01
NA,那覇市,NA,9466,9461,5,12502,12497,5,75,70,2017-02-01
